111111111111111111111111111111111
1....1..1..........1...1........1
1....1..1....M..11..1.......M...1
1..........11......1......1.....1
1...........11111111....1111.1111
11111..................1....1...1
1......................1...1....1
1......................1..1.....1
111111......111111111111........1
1.............1.................1
1.............1.....M.....1111..1
1.....1.......1.........11......1
1.....1...P.........1111........1
1.....1...........11........11111
1....1111...111111....M...1..1..1
1....1.......1..................1
1....1.......1......1111......1.1
1....1.......1...111.....1.....11
1....1.......1...1...11111..1...1
1....1.......1......1....1111...1
111111....11111....1..111.......1
1........1....1..111........11111
1.......1.....1111....111.....1.1
1......1......1..1............1.1
1...111...M...1111...11.........1
1.....1.......1..1..1.1.........1
1.........1......1111..111111...1
1..........1...............1....1
111111111111111111111111111111111